################
#R  1          #
#              #
#              #
################